html-2
-입력 양식(form) 태그 ; 입력 양식을 만들 때 사용하는 태그
입력 양식에 입력된 내용은 서버로 전송되어 구현된 웹 응용 프로그램이 구동되어 데이터베이스와 연동 
-유효한 코드를 사용하지 않으면, 브라우저는 자체적인 방법으로 코드를 해석 하여 가끔은 개발자가 원하지 않은 결과를 보여줌. 웹 페이지를 올바로 처리하기 위해서는 어떤 DTD(Document Type Definition, 문서 유형 정의)를 사용해야 하는지 브라우저가 알 수 있어야만, HTML 문서 의 유효성 검사가 가능하고 유효성 검사를 하게 되면 개발하고 있는 웹 페이지에 원하는 모습으로 제대로 표현되는지, 아니면 어떤 문제가 있어 웹 문서가 제대로 표현이 안 되고 있는 지 알 수 있기 때문에, 유효성 검사는 중요

<script> 내에 function으로 함수를 만들어 사용 가능
action : 입력 데이터의 전달 위치를 지정
method: 입력 데이터의 전달 방식을 선택 
-get : url에 포함되어 전송(query String 형식)
<name=”n1”/><name=”n2”/>일 때, url에 “?n1=value&n2=value”에 추가하여 
-post : 입력한 데이터가 눈에 보이지 않게 전송(url이 아니라 데이터 영역을 이용해서 데이터를 전송하기에 웹브라우저나 서버 상관없이 파라미터 길이 제한이 없다)
button : 버튼을 생성
checkbox : 체크박스을 생성
file : 파일 입력 양식을 생성
hidden : 보이지 않게 합니다.
image : 이미지 형태를 생성
password : 비밀번호 입력 양식을 생성
radio : 라디오 버튼을 생성
reset : 초기화 버튼을 생성
submit : 제출 버튼을 생성
text : 글자 입력 양식을 생성
autofocus : 포커스 자동 설정
placeholder : 각 필드에 대한 입력 형식 힌트제공
required : 필수 입력 필드
min, max : 숫자의 범위를 설정
pattern : 조건을 사용한 일반식 표시
사용자 인터페이스를 높이기 위한 label이용


공간분할 태그(레이아웃태그) 
div : block 형식으로 공간을 분할 . 하나의 블록형식의 태그므로 개행포함 ex)p, ul안의 li
span : inline 형식으로 공간을 분할


시멘틱을 이용한 레이아웃
-일반적으로 HTML5 태그의 가장 큰 변화를 시멘틱 태그라고 한다. 
-웹 페이지는 글자로 입력한다. 스타일시트를 적용하여 눈으로 볼 때, 제목, 본문으로구분
- 시멘틱 웹의 장점은 검색엔진이 보다 효율적으로 검색을 할 수 있고 유지보수시 효율적
HTML5 시멘틱 구조 태그
header : 해더
nav : 내비게이션
aside : 사이드에 위치하는 공간
section : 여러 중심 내용을 감싸는 공간
article : 글자가 많이 들어가는 부분
footer : 꼬리말
















